NO ./textures/wall_1.png

SO ./textures/wall_2.png

WE ./textures/wall_3.png

EA ./textures/wall_4.png

F 220,100,0
C 225,30,0

1111111111
1N00000001
1001000001
1111111111
