NO ./textures/wall_1.png

SO ./textures/wall_2.png

WE ./textures/wall_3.png

EA ./textures/wall_4.png

F 155,155,155
C 70,130,180


1111111111
1000000001
1001N00001
1111111111
111