NO ./textures/wall_1.png

SO ./textures/wall_2.png

WE ./textures/wall_3.png

EA ./textures/wall_4.png

F 155,155,155
C 70,130,160

11111111111111
10E00000000001
10001000000001
10010100000001
11111111111111