NO ./textures/wall_1.png

SO ./textures/wall_2.png

WE ./textures/wall_3.png

EA ./textures/wall_4.png

F 155,155,155
C 70,130,160

1111111111
10000N0001
1001000001
111111111
1111