NO ./textures/wall_1.png

SO ./textures/wall_2.png

WE ./textures/wall_3.png

EA ./textures/wall_4.png

F 225,30,0
C 220,100,0

1111111111
1000000001
1001N00001
1111111111
111