NO ./textures/wall_1.png

SO ./textures/wall_2.png

WE ./textures/wall_3.png

EA ./textures/wall_4.png

F 48, 27, 104
C 9, 24, 51

111111111111
100000000001
100010011101
100000000101
101110S01101
100000000001
100011111111
10001
10011
10001
11111