NO ./textures/wall_1.png

SO ./textures/wall_2.png

WE ./textures/wall_3.png

EA ./textures/wall_4.png

F 48, 27, 104
C 9, 24, 51

11111111111111111111
10000000000000000001
10000000001000110111
10000100001001000001
10000000000011111001
10000000000000000001
10000N00100111111001
11111111100000000001
11111111111111111111