NO ./textures/wall_1.png

SO ./textures/wall_2.png

EA ./textures/wall_3.png

WE ./textures/wall_4.png

F 48, 27, 104
C 9, 24, 51

11111111111
100000000001
101000110111  1
101001000001 101
1S0011111001  1
100000000001
100111111001
100000000001
100000000001111111111
100000000000000000001
100000111000000000001
100000000001111111111
111111111111