NO ./textures/wall_1.png

SO ./textures/wall_2.png

EA ./textures/wall_4.png

WE ./textures/wall_3.png


F 48, 27, 104
C 9, 24, 51

111111111111
100000000001
101000110111
101001000001
100011111001
100000S00001
100111111001
100000001001
111111111001111111111
100000000000000000001
100000111000000000001
100000000001111111111
111111111111